9 12 6
0 0
8 9
............
.....#.#####
.....#......
.###########
..........#.
.....#..#.##
.....#..#.##
.....#..#...
........#...