9 12 9
0 0
8 11
............
..#########.
..........#.
..........#.
..........#.
..........#.
..........#.
..........#.
..........#.
..........#.