10 12 6
3 2
8 7
............
............
............
......#####.
......#...#.
......#.#.#.
......#.#.#.
......#.#...
......#.#...
.......#....