10 9 1
4 1
8 7
#........
.#.#####.
.#.....#.
.#.#.###.
#..#...#
.#.###.#.
.#.....#.
.#######.
.........
.#######.